name	alias
06 BG	06-Benzylguanine
06-BG	06-Benzylguanine
06-BG (NABTT 0803)	06-Benzylguanine
06BG	06-Benzylguanine
06GB	06-Benzylguanine
17-AAG	Demethoxygeldanamycin
17-AAG	Tanespimycin
17AAG	Demethoxygeldanamycin
2-[1-hexyloxyethyl]-2-devinyl pyropheophorbide-alpha (HPPH or Photochlor)	Photochlor
2B3-101	Doxorubicin
5 FU	Fluorouracil
5 Flourouracil	5 fluorouracil
5 Fluoruoracil	5-fluorouracil
5 fluorouracil	Fluorouracil
5 fluorouracil+leucovorin	Fluorouracil+Leucovorin
5 fluorouracilum	Fluorouracil
5 fluorouracilum+leucovorin	Fluorouracil+Leucovorin
5- FU	Fluorouracil
5-FLUOROURACIL	Fluorouracil
5-FU	Fluorouracil
5-FU + LEULOV	Fluorouracil+Leucovorin
5-FU+ etoposidium	Fluorouracil+Etoposide
5-Flourouracil	5-fluorouracil
5-Flourouracil	Fluorouracil
5-Fluorouracil	Fluorouracil
5-Fluorouracil + leucovorin	Fluorouracil+Leucovorin
5-Fluorouracil?	Fluorouracil
5-Fluoruoracil	5-fluorouracil
5-Fluoruoracil	Fluorouracil
5-fluorouracil	Fluorouracil
5-fluorouracilum	Fluorouracil
5-flurouracil	Fluorouracil
5-fu	Fluorouracil
58500	NO-FIND
5F4 LEUCOVORIN	Leucovorin
5F4 Leucovorin	Fluorouracil+Leucovorin
5FU	Fluorouracil
5fluorouracil	5 fluorouracil
5fluorouracil+leucovorin	Fluorouracil+Leucovorin
5fluorouracil+oxaciplatina+l-folinian discido	Oxaliplatin+Leucovorin+Fluorouracil
6 THIGUANINE	Tioguanine
6 THIOGUANINE	Tioguanine
6 Thiguanine	'Tioguanine'
6 Thiguanine	6-thioguanine
6-MERCAPTOPURINE	Tioguanine
9 AMINOCAMPTOTHECIN	9-AMINOCAMPTOTHECIN
9 Aminocamptothecin	Aminocamptothecin
9 IMMUNOAMINO CAMPTNETECIN	9-AMINOCAMPTOTHECIN
90Y-HU3S193	Hu3S193
97212	NO-FIND
A202171 Protocol	NOS
ABRAXANE	Paclitaxel
ABT-888	Veliparib
ABT-888 PARP INHIBITOR	Veliparib
ABT-888 and temozolomide	Veliparib+Temozolomide
ABT263	Navitoclax
ABT888	Veliparib
ABTC 0603 HYDROXYCHLOROQUINE	Hydroxychloroquine
AC	Cyclophosphamide+Doxorubicin
ACCTUANE	Isotretinoin
ACCUTANE	Isotretinoin
ADRIAMYCIN	Doxorubicin
ADRIMYCIN	Doxorubicin
AE 788	AE788
AE-37	AE37
AFINITOR	Everolimus
AKT inhibitor VIII (1)	akt inhibitor viii
ALBUMIN-BOUND PACLITAXEL	Paclitaxel
ALIMTA	Pemetrexed
ALMITA	Pemetrexed
AMG 102	Rilotumumab
AMG 706	Motesanib
AMG 706	motesanib
AMG706	motesanib
AMGEN 706	motesanib
AMITOSTIN	Amifostine
AMITOSTINE	Amifostine
ANASTROZOLE (ARIMIDEX)	Anastrozole
ANTI NEOPASTONS	Anti Neoplastons
AP-23573 (ARIAD)	Ridaforolimus
AP24534	ponatinib
ARIAD AP23573	Deforolimus
ARIMIDEX	Anastrozole
ARIMIDEX (ANASTROZOLE)	Anastrozole
ARMIDEX	Anastrozole
AROMASIN	Exemestane
AROMASIN (EXEMESTANE)	Exemestane
ARSENIC TNOXIDE	ARSENIC TRIOXIDE
AT 101	AT-101
ATTAC	NO-FIND
AVASTIN	Bevacizumab
AVASTIN (BEVACIZUMAB)	Bevacizumab
AVASTIN/BEVACIZUMAB/PLACEBO	Bevacizumab
AZ628	Sorafenib tosylate
AZD 2281	Olaparib
AZD0530	saracatinib
AZD2281	Olaparib
AZD6244	Selumetinib
Abagovomab or Placebo	Abagovomab
Abagovomab vs Placebo	Abagovomab
Abagovomag	abagovomab
Abagovomag vs Placebo	Abagovomab
Abraxane	Paclitaxel
Acctuane	accutane
Actinomycin-D	Dactinomycin
Adriamycin	Doxorubicin
Adriamycin (doxorubicin)	Doxorubicin
Adriamycin, cytoxan, avastin	Doxorubicin+Cyclophosphamide+Bevacizumab
Adriamycin/Cytoxan	Doxorubicin+Cyclophosphamide
Adriamyicin	Doxorubicin
Adrimycin	Doxorubicin
Adrimycin	adriamycin
Afinitor	Everolimus
Aflibercept/ Placebo Study	Aflibercept
Agent	NO-FIND
Albumin-Bound Paclitaxel	Paclitaxel
Alimta	Pemetrexed
Alkeran	Melphalan
Almita	Pemetrexed
Almita	alimta
Aloxi	Palonosetron
Alpha Interferon	Alferon
Altima	Pemetrexed
Amatuximab (MORab-009)	Amatuximab
Amgen 706	Motesanib
Amgen 706	amg 706 amgen
Amitostin	Amifostine
Amitostine	Amifostine
Anastrazole	Anastrozole
Anti necplatens	Antineoplastons
Arimidex	Anastrozole
Arimidex (Anastrozole)	Anastrozole
Armidex	Anastrozole
Armidex	arimidex
Armour Thyroid	Desiccated thyroid
Aromasin	Exemestane
Aromasin (Exemestane)	Exemestane
Avastin	Bevacizumab
Avastin (Bevacizumab)	Bevacizumab
Avastin/bevacizumab/placebo	Bevacizumab
Axitnib	Axitinib
B12	Cyanocobalamin
BA4 43	Sorafenib
BA4 43 9006	Sorafenib
BAY-439006	Sorafenib
BCG, Intravesicular	BCG
BCNU	Carmustine
BCNU (CARMUSTINE)	Carmustine
BCNU (Carmustine)	Carmustine
BCNU (carmustine)	Carmustine
BEVACIZUMAB (AVASTIN)/PLACEBO PROVIDED BY STUDY	Bevacizumab
BEVACIZUMAB AVASTIN	Bevacizumab
BEVACOZIMAB	Bevacizumab
BIBW 2992	Afatinib
BIBW2992	Afatinib
BISPHOPHONATE (ZOLEDRONIC ACID)	zoledronate
BRAF inhibitor	Vemurafenib
BROMO DEOXYURIDINE	Bromodeoxyuridine
BRYOSTATIN1	Bryostatin 1
BS1 201	Iniparib
BS1-201	Iniparib
BS1-201	Iniparib
BSI-201	Iniparib
BX796	NO-FIND
Bacillus Calmette-Guerin (BCG)	BCG
Bay-439006	Sorafenib
Benzylguanine	O6-Benzylguanine
Bevacizamab	bevacizumab
Bevacizamab/Placebo	Bevacizumab
Bevacizumab or Placebo	Bevacizumab
Bevacizumab or placebo	Bevacizumab
Bevacizumab vs Placebo	Bevacizumab
Bevacizumiab/ versus Placebo	Bevacizumab
Bevacozimab	bevacizumab
Bevcizumab	bevacizumab
Bicalutamid	Bicalutamide
Bromo deoxyuridine	Bromodeoxyuridine
C1 FOLFIRI/Zaltrap	Leucovorin+Fluorouracil+Irinotecan+Aflibercept
CALCIUM FOLIATUM	Calcium Folate
CALCIUM FOLIATUM 420MG	Calcium Folate
CAMPTOSAR	Irinotecan
CAPECETABINE	Capecitabine
CAPECITABIN	Capecitabine
CARBO	Carboplatin
CARBOBPLATIN	Carboplatin
CARBOPALTIN	Carboplatin
CARBOPLASTIN	Carboplatin
CARBOPLATIN #1	Carboplatin
CARBOPLATIN 6TH	Carboplatin
CARBOPLATINUM	Carboplatin
CARBOXY AMIDO TRIAZOLE	Carboxyamidotriazole
CARBPLATIN	Carboplatin
CARMUSTIN	Carmustine
CARMUSTINE (BCNU)	Carmustine
CARMUSTINE BCNU	Carmustine
CASODEX	Bicalutamide
CATUMAXUMAB	Catumaxomab
CAV Trial	Cyclophosphamide+Dactinomycin+Vincristine
CCDP	Cisplatin
CCNU	Lomustine
CCNu	Lomustine
CDDP	Cisplatin
CDR0000654697	NOS
CELBREX	Celecoxib
CELEBREX	Celecoxib
CEP 11981	CEP -11981
CEP 11981	CEP11981
CEP701	Lestaurtinib
CEPECITABINE	CAPECITABINE
CETUXIMEB	Cetuximab
CHOP	Cyclophosphamide+Doxorubicin+Vincristine+Prednisone
CI 980	CI-980
CI1040	CI-1040
CI980	CI-980
CILENAITIDE	Cilengitide
CIPLASTIN	Cisplatin
CIS Retinoic Acid	Isotretinoin
CIS-RETINOIC ACID	Cis Retinoic Acid
CISPLASTIN	Cisplatin
CISPLATAIN	Cisplatin
CISPLATIN #2-7	Cisplatin
CISPLATINUM	Cisplatin
CISPLATINUM 120MG	Cisplatin
CISTPLATIN	Cisplatin
CISplatinum	Cisplatin
CLODRONATE	Clodronic acid
CMK	KIN001-128
COPOLANG CAPS	Cyclophosphamide+Polysaccharide-K
CPT 11	Irinotecan
CPT-11	Irinotecan
CPT11	Irinotecan
CPT11	cpt 11
CRA	Isotretinoin
CT2103 TAXANE ANALOG	CT-2103
CT2103 Taxane Analog	Paclitaxel
CVAD	Cyclophosphamide+Vincristine+Doxorubicin+Dexamethasone
CYC-116/Cyclocel	Cyclophosphamide+CYC116
CYCLOPHASPHAMIDE	Cyclophosphamide
CYCLOPHOSPAMIDE	Cyclophosphamide
CYCLOPHOSPHAMID+METOTREKSAT+  FLUOROURACIL	Cyclophosphamide+Methotrexate+Fluorouracil
CYOTXAN	Cyclophosphamide
CYTOXAN	Cyclophosphamide
CYTOXAN AND TAXOTERE	Cyclophosphamide+Docetaxel
CYTOXEN	Cyclophosphamide
CYTOXIN	Cyclophosphamide
Calcium Foliatum	Leucovorin
Calcium Foliatum, fluorouracilum, oxaliplatinum, dexamethassone	Leucovorin+Oxaliplatin+Fluorouracil+Dexamethasone
Camptosar	Irinotecan
Cancer Vax	Polyvalent Melanoma Vaccine
Capecetabine	Capecitabine
Capecetabine	capecitabine
Capecitabin	Capecitabine
Capecitabine -xeloda	Capecitabine
Capecytabinum	Capecitabine
Carbo	Carboplatin
CarboPlatinum	Carboplatin
Carbobplatin	Carboplatin
Carboplatin #1	Carboplatin
Carboplatin & Paclitaxel	Carboplatin
Carboplatin 5 AUC	Carboplatin
Carboplatin 6th	Carboplatin
Carboplatin Paclitaxel	Carboplatin+Paclitaxel
Carboplatin and Paclitaxel	Carboplatin+Paclitaxel
Carboplatin, Taxol	Carboplatin+Paclitaxel
Carboplatin/Paclitaxel	Carboplatin+Paclitaxel
Carboplatin/Paclitaxel/Bevacizumab	Carboplatin+Paclitaxel+Bevacizumab
Carboplatin_Paclitaxel	Carboplatin+Paclitaxel
Carboplatinum	Carboplatin
Carbplatin	Carboplatin
Carbplatin	carboplatin
Carmustin	Carmustine
Carmustine (BCNU)	Carmustine
Carmustine BCNU	Carmustine
Casodex	Bicalutamide
Catumaxumab	Catumaxomab
Catumaxumab	catumaxomab
Cedicanib	Cediranib
Cediranib Placebo	Cediranib
CeeNU	Lomustine
Celbrex	celebrex
Celebrex	Celecoxib
Cepecitabine	Capecitabine
Cepecitabine	capecitabine
Cetuximab Study drug	Cetuximab
Chemo	NO-FIND
Chemo Multi	NO-FIND
Chemo NOS	NO-FIND
Chemo, Multi-Agent, NOS	NOS
Chemo, NOS	NO-FIND
Chemo, NOS	NOS
Ciclosporin	Cyclosporine
Cilenaitide	Cilengitide
Cilengtide	Cilengitide
Ciplastin	Cisplatin
Ciplastin	cisplatin
Cis Retinoic Acid	Isotretinoin
Cisplatain	cisplatin
Cisplatin #2-7	Cisplatin
Cisplatin, pemetrexed	Cisplatin+Pemetrexed
Cisplatin-xrt	Cisplatin
Cisplatin/Etoposide	Cisplatin+Etoposide
Cisplatin/Gemzar	Cisplatin+Gemcitabine
Cisplatinum	Cisplatin
Cisplatnin	Cisplatin
Clinical Trial	NOS
Clinical Trial-Study Agent	NOS
Clinical trial	NOS
Cloretazine	Laromustine
Copolang	Cyclophosphamide+Polysaccharide-K
Cyclophasphamide	Cyclophosphamide
Cyclophasphamide	cyclophosphamide
Cyclophospamide	Cyclophosphamide
Cyclophospamide	cyclophosphamide
Cyclophosphane	Cyclophosphamide
Cyotxan	Cyclophosphamide
Cyotxan	cytoxan
Cytomel	Liothyronine
Cytoxan	Cyclophosphamide
Cytoxan and Taxotere	Cyclophosphamide+Docetaxel
Cytoxan, vincristine and dacarbazine	Cyclophosphamide+Vincristine+Dacarbazine
Cytoxen	Cyclophosphamide
Cytoxen	cytoxan
Cytoxin	Cyclophosphamide
DECODRON	Dexamethasone
DEXAETHASONE	Dexamethasone
DEXAMETHASOME	Dexamethasone
DEXAMETHASSONE	Dexamethasone
DEXAMETHAZONE	Dexamethasone
DEXAMETHSONE	Dexamethasone
DEXAMTHASONE	Dexamethasone
DEXMETHASONE	Dexamethasone
DMOG	Dimethyloxaloylglycine
DOCETOXEL/TAXOTERE	Docetaxel
DOXETAXEL	Docetaxel
DOXIL	Doxorubicin
DOXORIBICIN	Doxorubicin
DOXORUBICIN HCI LIIPOSOMAL	Doxorubicin
DOXORUBICIN HCI LIPSOME	Doxorubicin
DOXORUBICIN HCL	Doxorubicin
DOXORUBICIN HCL LIPOSOMAL	Doxorubicin
DOXORUBICIN HCL LIPOSOMAL -DOXIL	Doxorubicin
DOXORUBICIN+CYCLOPHOSPHAMID	Cyclophosphamide+Doxorubicin
DOXORUBICINE CYCLOPHOSPHAMIDE (ENDOXAN ADVIBLASTIN)	Cyclophosphamide+Doxorubicin
DOXORUBINCIN	Doxorubicin
DOXORUBINCIN HCL	Doxorubicin
DTIC	Dacarbazine
DTIC, Dacarbazine	Dacarbazine
Dacabarzine	Dacarbazine
Dacarbazine (DTIC)	Dacarbazine
Decodron	Dexamethasone
Decodron	decadron
Dexaethasone	dexamethasone
Dexamethasome	dexamethasone
Dexamethasone phosphate	Dexamethasone
Dexamethsone	dexamethasone
Dexamthasone	dexamethasone
Dexmethasone	dexamethasone
Docetaxel +/- Zactima	Docetaxel+Vandetanib
Docetaxelum	Docetaxel
Docetoxel/Taxotere	Docetaxel
Docorubicin	doxorubicin
Doxetaxel	Docetaxel
Doxetaxel	docetaxel
Doxetaxol	Docetaxel
Doxetaxol	docetaxel
Doxifluridin	Doxifluridine
Doxil	Doxorubicin
Doxil & Carboplatin	Doxorubicin+Carboplatin
Doxirubicin	Doxorubicin
Doxobubicin	Doxorubicin
Doxorubican	doxorubicin
Doxorubicin HCI Liiposomal	Doxorubicin
Doxorubicin HCI Lipsome	Doxorubicin
Doxorubicin HCL	Doxorubicin
Doxorubicin HCL Liposomal	Doxorubicin
Doxorubicin HCL Liposomal -Doxil	Doxorubicin
Doxorubicin HCl Liposomal	Doxorubicin
Doxorubicin Liposome	Doxorubicin
Doxorubicinum	Doxorubicin
Doxorubincin	doxorubicin
Doxorubincin HCL	Doxorubicin
E-75	Nelipepimut-S
EMD	NOS
EMD 121974	Cilengitide
EPIRUBICINUM 70MG	Epirubicin
EPOCH	Etoposide+Prednisone+Vincristine+Doxorubicin
EPOTHILONEB	epothilone
ERBITUX	Cetuximab
ERLOTINIB	Erlotonib
ET-743	Trabectedin
ETC Posidum	Etoposide
ETOPOSDIE	Etoposide
ETOPOSIDE (VP16)	Etoposide
ETOPSIDE	Etoposide
EXEMESTANE (AROMASIN)	Exemestane
Eligard	Leuprolide
Eloxatin	Oxaliplatin
Eloxatin(oxaliplatin)	Oxaliplatin
Enoticumab	REGN421
Epirubicoin	Epirubicin
Erbitux	Cetuximab
Erlotonib	Erlotinib
Erlotonib	erlotinib
Erythropoietin	Epoetin
Etoposid	Etoposide
Etoposide (VP16)	Etoposide
Etoposide phosphate	Etoposide
Etopside	Etoposide
Everolimus, Gemcitabine, and Cisplatin	Everolimus+Gemcitabine+Cisplatin
FARESTON	Toremifene
FASLODEX	Fulvestrant
FEMARA	Letrozole
FEMARA (LETROZOLE)	Letrozole
FILGRASTIM (G-CSF)	Filgrastim
FLC	NOS
FLOURORACIL	Fluorouracil
FLOUROURACIL	Fluorouracil
FLOUROURACIL	fluorouracil
FLUOROURACILUM	Fluorouracil
FLUOROURACILUM 2100MG	Fluorouracil
FOLFIRI	Leucovorin+Fluorouracil+Irinotecan
FOLFIRI/Avastin	Leucovorin+Fluorouracil+Irinotecan+Bevacizumab
FOLFOX	Leucovorin+Fluorouracil+Oxaliplatin
FOLINIC ACID	Leucovorin
FOTEMUSTINA	Fotemustine
FT	Ftorafur
FTI277	FTI-277
FU7	NOS
FUDR (FLOXURIDINE)	Floxuridine
FUDR (Floxuridine)	Floxuridine
FULUESTRANT	Fulvestrant
FULVESTRANT (FASLODEX)	Fulvestrant
Fareston	Toremifene
Faslodex	Fulvestrant
Femara	Letrozole
Femara (Letrozole)	Letrozole
Filgrastim (G-CSF)	Filgrastim
Firmagon	Degarelix
Flourouracil	fluorouracil
Floxuridine	Fluorouracil
Fluorouracil (5-FU)	Fluorouracil
Fluorouracil IV Continuous infusion over 46 hours	Fluorouracil
Fluorouracilum	Fluorouracil
Fluoruoracil	fluorouracil
Fluoruracil	Fluorouracil
FolFox	Leucovorin+Fluorouracil+Oxaliplatin
Folfiri	Leucovorin+Fluorouracil+Irinotecan
Folfox	Leucovorin+Fluorouracil+Oxaliplatin
Folinic Acid	Leucovorin
Folinic acid	Leucovorin
Fuluestrant	Fulvestrant
Fuluestrant	fulvestrant
Fulvestrant (Faslodex)	Fulvestrant
GAMINOCAMPTOTHECIN	aminocamptothecin
GAMZAR	Gemcitabine
GDC0449	Vismodegib
GDC0941	GDC-0941
GEMAR	Gemcitabine
GEMCITABIN	Gemcitabine
GEMCITABINE HCI	Gemcitabine
GEMCITABINE HCL	Gemcitabine
GEMCITABINE/CISPLATIN	Gemcitabine+Cisplatin
GEMCITIBANE	Gemcitabine
GEMCITIBINE	Gemcitabine
GEMICITABINE	Gemcitabine
GEMICTIABINE	Gemcitabine
GEMZAN	Gemcitabine
GEMZAR	Gemcitabine
GEMZAR (GEMCITABINE)	Gemcitabine
GEMZET	Gemcitabine
GEZMAR	Gemcitabine
GLEEVAC	Imatinib
GLEEVEC	Imatinib
GLIADEL	Carmustine implant
GLIADEL BCNU	Carmustine implant
GLIADEL WAFER	Carmustine implant
GLIADEL WAFER (BCNU)	Carmustine implant
GLIADEL WAFER CARMUSTINE	Carmustine implant
GLIADEL WAFERS	Carmustine implant
GLIADEL WATERS	Carmustine implant
GLIADLE WAFER	Carmustine implant
GM-CSF	Sargramostim
GOG182	GOG 182
GOMZAR	Gemcitabine
GP-100	GP100
GSK Braf Inhibitor	Dabrafenib
Gadoinium	gadolinium
Gaminocamptothecin	Aminocamptothecin
Gamzar	Gemcitabine
Gamzar	gemzar
Gemar	Gemcitabine
Gemcitabine (Gemzar)	Gemcitabine
Gemcitabine HCI	Gemcitabine
Gemcitabine HCL	Gemcitabine
Gemcitabine Injection	Gemcitabine
Gemcitabine and Cisplatin	Gemcitabine+Cisplatin
Gemcitibane	Gemcitabine
Gemcitibane	gemcitabine
Gemcitibine	Gemcitabine
Gemicitabine	Gemcitabine
Gemicitabine	gemcitabine
Gemox	Gemcitabine+Oxaliplatin
Gemzan	Gemcitabine
Gemzan	gemzar
Gemzar	Gemcitabine
Gemzar (Gemcitabine)	Gemcitabine
Gemzet	Gemcitabine
Genentech	NO-FIND
Genentech Cpd	NO-FIND
Genentech Cpd 10	NO-FIND
Gezmar	Gemcitabine
Gleevec	Imatinib
Gliadel	Carmustine
Gliadel Wafer	Carmustine
Gliadel Wafers	Carmustine
Gliadel wafers	Carmustine
Gomzar	Gemcitabine
HEC.1 - Sorafenib vs Sorafenib plus Doxorubicin	HEC.1
HERCEPTIN	Trastuzumab
HERCPTIN	Trastuzumab
HEXALEN	Altretamine
HEXALIN	Altretamine
HEXAMETHYLMELAMINE	Altretamine
HEXAMETHYMELAMINE	Altretamine
HEXLALEN	Altretamine
HG-5-113-01	NO-FIND
HG-5-88-01	NO-FIND
HIGH DOSE INTERLEUKIN-2	Interleukin-2
HSC vaccine injection	NOS
HYDOXYUREA	Hydroxycarbamide
HYDROCHOROQUINE	Hydroxychloroquine
HYDROXUREA	Hydroxycarbamide
HYDROXYUEREA	Hydroxycarbamide
HYDROXYUREA	Hydroxycarbamide
HYDROYUREA	Hydroxycarbamide
HYRDROXYUREA	Hydroxycarbamide
HYROXYUREA	Hydroxycarbamide
Halaven	Eribulin
Halichondrin	Halichondrin B
Herceptin	Trastuzumab
Hexalen	Altretamine
Hexalin	Altretamine
Hexamethylmelamine	Altretamine
Hexamethymelamine	Altretamine
High dose	NO-FIND
High dose Methotrexate w/ Leucovorin	Methotrexate+Leucovorin
High dose ara-c	Cytarabine
High dose ara-c	NO-FIND
Hormone, NOS	NOS
Hydoxyurea	Hydroxyurea
Hydoxyurea	hydroxyurea
Hydrochoroquine	hydroxychloroquine
Hydroxurea	hydroxyurea
Hydroxydaunomycin	Doxorubicin
Hydroxyuerea	hydroxyurea
Hydroyurea	Hydroxyurea
Hydroyurea	hydroxyurea
Hyrdroxyurea	hydroxyurea
Hyroxyurea	hydroxyurea
I 131 81C6	81C6
I-131	Iodine-131
I131-81C6	81C6
ICE	Ifosfamide+Carboplatin+Etoposide
ICT 107	NO-FIND
ICT-107	NO-FIND
IFN-ALPHA (INTRON)	Hydroxycarbamide
IFN-Alpha (Intron)	Interferon A
IFOSTAMIDE	Ifosfamide
IL 12	INTERLEUKIN-12
IL 12	Interleukin-12
IL 12	NO-FIND
IL 13	INTERLEUKIN-13
IL 13	NO-FIND
IL 13PE	NO-FIND
IL 2	Aldesleukin
IL 2	INTERLEUKIN-2
IL-13 PSEUDOMONAS EXOTOXIN	IL-13 WITH PSEUDOMONAS EXOTOXIN
IL-13-PE38QQR CYTOXIN	IL-13 WITH PSEUDOMONAS EXOTOXIN
IL-13PE	Cintredekin
IL-13PE	IL-13 WITH PSEUDOMONAS EXOTOXIN
IL-18	Interleukin-18
IL-2	Aldesleukin
IL-2	INTERLEUKIN-2
IL-2 (HIGH DOSE)	INTERLEUKIN-2
IL-2 (high dose)	Aldesleukin
IL-2 THEARPY (INTERLEUKIN)	INTERLEUKIN-2
IL-2 Therapy (interleukin)	Aldesleukin
IL2	Aldesleukin
IMC-A12	Cixutumumab
INF	Infliximab
INTERFERON-ALPHA	INTERFERON ALPHA
INTERLEUKIN 2-HIGH DOSE	INTERLEUKIN-2
INVESTIGAL DRUG AVASTIN	Bevacizumab
IRESSA	Gefitinib
IRESSA PLACEBO VS. DRUG	Gefitinib
IRESSA placebo vs. drug	Gefitinib
IRINOTEACAN	Irinotecan
IRINOTECAN HCL	Irinotecan
IRINOTECAN+5-fluorouracilim	Irinotecan+Fluorouracil
IRINOtecan HCl	Irinotecan
IRINTOTECAN	Irinotecan
IRONOTECAN	Irinotecan
IRRESSA	Gefitinib
IRUNOTECAN	Irinotecan
ISOTRECTINOIN (ACCCUTANE)	Isotretinoin
Ifex	Ifosfamide
Ifosfamid	Ifosfamide
Ifostamide	Ifosfamide
Ifostamide	ifosfamide
Infusion	NO-FIND
Inhibitor	NO-FIND
Interferon	NOS
Interferon Alpha	Interferon A
Interferon alfa	Interferon A
Interferon alfa-2b	Interferon A
Interferon alpha	Interferon A
Interferon gamma	Interferon G
Interferon-?2	Aldesleukin
Interferon-alfa	Interferon A
Interleukin - 2	Aldesleukin
Interleukin 2-high dose	Aldesleukin
Interleukin-2	Aldesleukin
Intrathecal Methotrexate	Methotrexate
Intron A	Interferon A
Investigal drug Avastin	Bevacizumab
Iressa	Gefitinib
Irinotecan + Cetuximab	Irinotecan+Cetuximab
Irinotecan HCL	Irinotecan
Irinotecan HCl	Irinotecan
Irinotecan Hydrochloride	Irinotecan
Irintocean	Irinotecan
Irintotecan	Irinotecan
Irintotecan	irinotecan
Irolfluvin	Irofulven
Ironotecan	Irinotecan
Ironotecan	irinotecan
Irressa	Gefitinib
Isotrectinoin (acccutane)	Isotretinoin
JQ1 (1)	NO-FIND
JQ1 (2)	NO-FIND
JQ1 1	NO-FIND
JQ1 2	NO-FIND
JW-7-24-1	NO-FIND
JW-7-52-1	NO-FIND
KARERLTECIN	karenitecin
KIN001	NO-FIND
KIN001 236	NO-FIND
KIN001 244	NO-FIND
KIN001 260	NO-FIND
KIN001 266	NO-FIND
KIN001 270	NO-FIND
KIN001-236	NO-FIND
KIN001-244	NO-FIND
KIN001-260	NO-FIND
KIN001-266	NO-FIND
KIN001-270	NO-FIND
Karerltecin	Karenitecin
LETROZOLE (FEMARA)	Letrozole
LEUCOVORIN CALCIUM	Leucovorin
LEUPROLIDE ACETATE (LUPRON)	Leuprolide
LEVCOVORIN	Leucovorin
LEVENRACETAM	Levetiracetam
LHRH Agonist	LHRH
LHRH Agonist and Anti-Androgens Combined Androgen Blockade	LHRH
LIOSOMAL DOCORUBICIN	Liposomal doxorubicin
LIPOSOMAL DOXORUBICAN	Liposomal doxorubicin
LOMUSTIN	Lomustine
LOMUSTINE (CCNU)	Lomustine
LUMUSTINE	Lomustine
LUPRON	Leuprolide
LY317615	Enzastaurin
Laferon	Interferon A
Lestauritinib	lestaurtinib
Letrozol	Letrozole
Letrozole (Femara)	Letrozole
Leucovorin Calcium	Leucovorin
Leucovorin calcium	Leucovorin
Leukine	Sargramostim
Leuocvorin	Leucovorin
Leuprolide Acetate	Leuprolide
Leuprolide acetate	Leuprolide
Leuprorelin	Leuprolide
Levcovorin	Leucovorin
Levcovorin	leucovorin
Levenracetam	Levetiracetam
Levothroid	Levothyroxine
Levoxyl	Levothyroxine
Liosomal	NO-FIND
Liosomal Docorubicin	Doxorubicin
Liposomal	liposomal vitamin c
Liposomal Doxorubican	Doxorubicin
Liposomal Doxorubican	liposomal doxorubicin
Liposomal Doxorubicin	Doxorubicin
Liposomal doxorubicin	Doxorubicin
Lomustin	Lomustine
Lomustine (CCNU)	Lomustine
Lumustine	lomustine
Luprolide Depot	Leuprolide
Lupron	Leuprolide
Lymphocyte	NO-FIND
Lymphocyte Infusion	NO-FIND
Lymphocyte Infusion	NOS
MAB I	MABI131
MAB I 131	MABI131
MAB I-131	MABI131
MAB I131	MABI131
MAGE3	mage3 graphite
MAGI131-81C6	MABI131
MAGI131-81c6	81C6
MAb I	NO-FIND
MDX-1106 CLINICAL TRIAL	MDX-1106
MDX-1106 clinical trial	Nivolumab
MEGACE	Megestrol
MEGACE (ORAL)	Megestrol
MEL-44	Sargramostim
MELPHALON	Melphalan
MESNA-1	Mesna
MESNA-2	Mesna
METEXAFIN GADOLINIUM	MOTEXAFIN GADOLINIUM
METRONOMIC TEMODAR	Temozolomide
MGI 114	Irofulven
MGI 114	MGI-114
MITHRAMYCIN	Plicamycin
MITOMYCIN C	Mitomycin
MITOMYCINC	Mitomycin
MK2206	MK-2206
MLN8237	Alisertib
MOTEXATIN GADOINIUM	Motexafin gadolinium
MPS 1	NO-FIND
MPS-1-IN-1	NO-FIND
MS275	Entinostat
Mage A3	MAGE-A3
Mayo 425	NO-FIND
Mayo 425-20	NOS
Medrol	Methylprednisolone
Megace	Megestrol
Megace (oral)	Megestrol
Megestrol Acetate	Megestrol
Melphalon	Melphalan
Melphalon	melphalan
Micomycin	Mitomycin C
Mithramycin	Plicamycin
Mitomycin	Mitomycin C
Motexatin Gadoinium	Motexafin gadolinium
Multi	NO-FIND
Mustophoran	Fotemustine
NAB-RAPAMYCIN	Rapamycin
NABIT	NO-FIND
NABTT	NO-FIND
NAVELBINE	Vinorelbine
NEULASTA	Pegfilgrastim
NEXAVAAR	Sorafenib
NEXAVAR	Sorafenib
NOLVADEX	Tamoxifen
NPK76	NO-FIND
NUTLIN3A	Nutlin-3A
Navelbine	Vinorelbine
Naxavar	Sorafenib
Neulasta	Pegfilgrastim
Nexavaar	Sorafenib
Nexavaar	nexavar
Nexavar	Sorafenib
Nolvadex	Tamoxifen
Not otherwise	NO-FIND
Not otherwise specified	NO-FIND
Not otherwise specified	NOS
Not specified	NO-FIND
Not specified	NOS
O ICE	Ifosfamide+Carboplatin+Etoposide
O-ICE	Ifosfamide+Carboplatin+Etoposide
OBATOCLAXMESYLATE	Obatoclax mesylate
ORAL ETOPOSIDE	Etoposide
OS1-774	Tarceva
OSI906	Linsitinib
OVAREX MA6 B43.13	ovarex
OVAREX STUDY	ovarex
OVAREX/IND	ovarex
OVAREX/PLACEBO	ovarex
OXALIPLATINUM	Oxaliplatin
Oca Rex Oregovomab	Oregovomab
Oncophage	Vitespen
Oncovin	Vincristine
Oral Etoposide	Etoposide
Ovarex MA6 B43.13	Oregovomab
Ovarex Study	Oregovomab
Ovarex/IND	Oregovomab
Ovarex/Placebo	Oregovomab
Ovarex/placebo	Oregovomab
Oxaliplatin, Folinic acid, Fluorouracil	Oxaliplatin+Leucovorin+Fluorouracil
Oxaliplatinum	Oxaliplatin
Oxaloplatin	Oxaliplatin
PACILATXEL	Paclitaxel
PACILTAXAL	Paclitaxel
PACILTAXEL	Paclitaxel
PACILTAXLE	Paclitaxel
PACITAXEL	Paclitaxel
PACLIATXEL	Paclitaxel
PACLILTAXEL	Paclitaxel
PACLITAXEL (PROTEIN-BOUND)	Paclitaxel
PACLITAXEL; ALBUMIN-BOUNT	Paclitaxel
PACLITAXIL	Paclitaxel
PARAPLATIN	Carboplatin
PAXLITAXEL	Paclitaxel
PCV	Procarbazine+Lomustine+Vincristine
PD 0332991	Palbociclib
PEGFILGRASTIM (PEG G-CSF)	Pegfilgrastim
PEMETHEXED	Pemetrexed
PEMETREXED DISODIUM	Pemetrexed
PEP3 KLH	PEP-3-KLH
PF02341066	crizotinib
PF2341066	crizotinib
PI88	PI-88
PLFE/FLO	PLFE+Leucovorin+Fluorouracil+Oxaliplatin
PORTEC3-radiation alone	NOS
PREMETREXED	Pemetrexed
PROCARBAZINE/CCNU/VINCRISTINE	Procarbazine
PROCARBIZINE	Procarbazine
PROLEUKIN (IL-2)	Proleukin
PROVERA	Medroxyprogesterone
PS 341	Bortezomib
PS-341 BORTREZOMIB	Bortezomib
PS-341 Bortrezomib	Bortezomib
PSC833	Valspodar
PTK-ZK	Vatalanib
Pacilatxel	Paclitaxel
Paciltaxal	Paclitaxel
Paciltaxel	Paclitaxel
Paciltaxle	Paclitaxel
Pacitaxel	Paclitaxel
Pacitaxol	Paclitaxel
Pacliatxel	Paclitaxel
Pacliltaxel	Paclitaxel
Paclitaxel (Protein-Bound)	Paclitaxel
Paclitaxel; Albumin-Bount	Paclitaxel
Paclitaxil	Paclitaxel
Paclitaxol	Paclitaxel
Palixtaxel	Paclitaxel
Pamidronic acid	Pamidronate
Paraplatin	Carboplatin
Patrin	Lomeguatrib
Pegfilgrastim (Peg G-CSF)	Pegfilgrastim
Pemetrexed (Alimta)	Pemetrexed
Pemetrexed disodium	Pemetrexed
Placebo	NO-FIND
Platinol	Cisplatin
Polyplatillen	Cisplatin
Porfimer Sodium (Photofin)	Porfimer
Porfimer Sodium (Photofrin)	Porfimer
Porfimer Sodium(Photofin)	Porfimer
Posidum	NO-FIND
Predisone	Prednisone
Procarbizine	Procarbazine
Procarbizine	procarbazine
Proleukin	Aldesleukin
Protocol	NO-FIND
Provera	Medroxyprogesterone
QL VIII	NO-FIND
QL XI	NO-FIND
QL XII	NO-FIND
QL-VIII-58	NO-FIND
QL-X-138	NO-FIND
QL-XI-92	NO-FIND
QL-XII-47	NO-FIND
QL-XII-61	NO-FIND
R1507	Teprotumumab
RAD001	Everolimus
RAPAMCYIN	Sirolimus
RAPAMYCIN	Sirolimus
RBBX 01	rBBX-01
REINOID/CIS RETINOIC ACID	Cis Retinoic Acid
ROSCOVITINE	Seliciclib
Rapamcyin	rapamycin
Ras Inhibitor	NO-FIND
Reinoid	retinoid
Reinoid/CIS retinoic acid	retinoid
RenAmin	Amino Acids
Revlimid	Lenalidomide
Rhumab	Erlizumab
Rituxan	Rituximab
Roferon-A	Interferon A
SAHA	Vorinostat
SAHA/Vorinostat	Vorinostat
SCH 58500	NO-FIND
SCH 58500	SCH58500
SCH66336	Lonafarnib
SNS 595	Voreloxin
SNS 595	Vosaroxin
SOM 230	Pasireotide
SORAFENIB (BAY 43-9006)	Sorafenib
SORAFENIB - NEXAVAR	Sorafenib
SOVATENIB	Sorafenib
STUDY DRUG AMG 655	NA
SU101	leflunomide
SUNITINIB (SUTENT)	Sunitinib
SUTENT	Sunitinib
SUTENT (SUNITINIB)	Sunitinib
SYNTHROID	Levothyroxine
Sarafenib	Sorafenib
Sargramostin	Sargramostim
Sargramostin	sargramostim
Sorafenib (Bay 43-9006)	Sorafenib
Sorafenib - Nexavar	Sorafenib
Sorafinib ( Nexavar)	Sorafenib
Study	NO-FIND
Study drug	study drugs
Study drug AMG 655	Conatumumab
Sutent	Sunitinib
Sutent (Sunitinib)	Sunitinib
Sylatron	Peginterferon alfa-2a
Synthroid	Levothyroxine
TAMOXIFEN & MEGACE	NA
TAMOXIFEN (NOVADEX)	Tamoxifen
TAMOXITEN	Tamoxifen
TANCEVA	Erlotinib
TARCEVA	Erlotinib
TARVECA	Erlotinib
TAXANE	NA
TAXOL	Paclitaxel
TAXOL OR TAXOTERE	NA
TAXOL/CARBOPLATIN	Paclitaxel+Carboplatin
TAXOTERE	Docetaxel
TAXOTERECIN	Docetaxel
TC	Docetaxel+Cyclophosphamide
TCH	Docetaxel+Carboplatin+Trastuzumab
TEMADOR	Temozolomide
TEMAZOLOMIDE	Temozolomide
TEMODAR	Temozolomide
TEMODAR (ESCALATION)	Temozolomide
TEMODOR	Temozolomide
TEMOXOLOMIDE	Temozolomide
TEMOZLOMIDE	Temozolomide
TEMOZOLAMIDE	Temozolomide
TEMOZOLOMOIDE	Temozolomide
TEMOZOMIDE	Temozolomide
TEMUDAR	Temozolomide
THALOMID	Thalidomide
TIPFARNIB (R115777)	Tipifarnib
TIPIFARNIB (R115777)	Tipifarnib
TL-1-85	NO-FIND
TL-2-105	NO-FIND
TL32711	Birinapant
TOMAXIFEN	Tamoxifen
TOPECAN	TOPOTECAN
TOPETECAN	TOPOTECAN
TOPOTECAN HCL	TOPOTECAN
TOPOTECAN/CARBOPLATIN	TOPOTECAN+CARBOPLATIN
TOPTECAN	TOPOTECAN
TORISEL	Temsirolimus
TOXOTERE	Docetaxel
TRANSTUZUMAB	TRASTUZUMAB
TS-1	Tegafur+Gimeracil+Oteracil
Talimogene Laherparepvec (T-VEC)	Talimogene
Tamoxifen & Megace	Tamoxifen+Megestrol
Tamoxiten	Tamoxifen
Tamoxiten	tamoxifen
Tanceva	Erlotinib
Tarceva	Erlotinib
Tarceva (Erlotinib)	Erlotinib
Tarceva/Erlotinib	Erlotinib
Tarveca	tarceva
Taxane	NOS
Taxel	Paclitaxel
Taxol	Paclitaxel
Taxol or Taxotere	NOS
Taxol/Carboplatin	Paclitaxel+Carboplatin
Taxotere	Docetaxel
Taxotere/Cytoxan	Docetaxel+Cyclophosphamide
Taxoterecin	Docetaxel
Temazolomide	Temozolomide
Temazolomide	temozolomide
Temodal	Temozolomide
Temodar	Temozolomide
Temodor	temodar
Temoxolomide	temozolomide
Temozlomide	Temozolomide
Temozlomide	temozolomide
Temozolamide	Temozolomide
Temozolomode	temozolomide
Temozomide	Temozolomide
Temozomide	temozolomide
Tetrathiomolybdate	Tiomolibdate
Themozolomide	Temozolomide
Thiguanine	thioguanine
Threshold-302	Evofosfamide
Tivantinib (ARQ-197)	Tivantinib
Tomaxifen	Tamoxifen
Tomaxifen	tamoxifen
Topecan	Topotecan
Topecan	topotecan
Topetecan	Topotecan
Topotecan HCL	Topotecan
Topotecan HCl	Topotecan
Topotecan/Carboplatin	Topotecan+Carboplatin
Toptecan	Topotecan
Toptecan	topotecan
Torisel	Temsirolimus
Trelstar	Triptorelin
Trenantone	Leuprolide
Trustuzumab	Trastuzumab
Trustuzumab	trastuzumab
Tyrosine kinase inhibitor	NOS
Unkown	NOS
VATALANIB (PTK787)	Vatalanib
VECTIBIX	Panitumumab
VEGF-TRAP	Aflibercept
VELCADE	Bortezomib
VINCRISTIN	Vincristine
VINORELBINE TARTRATE	Vinorelbine
VNLG 124	NO-FIND
VNLG/124	NO-FIND
VOTRIENT	Pazopanib
VP 16	Etoposide
VP 16 (ETOPOSIDE)	Etoposide
VP-16	Etoposide
VP16	Etoposide
Velcade	Dortezomib
Vepesid	Etoposide
Vincristine (sulfate)	Vincristine
Vinorelbin	Vinorelbine
Vinorelbin Tartrate	Vinorelbine
Vinorelbine Tartrate	Vinorelbine
Votrient	Pazopanib
WZ-1-84	NO-FIND
Wafer	NO-FIND
XELODA	Capecitabine
XELODA (CAPECITABINE)	Capecitabine
XMD11	NO-FIND
XMD11 85h	NO-FIND
XMD11-85h	NO-FIND
XMD13	NO-FIND
XMD13 2	NO-FIND
XMD13-2	NO-FIND
XMD15	NO-FIND
XMD15 27	NO-FIND
XMD15-27	NO-FIND
XMD8 85	NO-FIND
XMD8-85	NO-FIND
XYOTAX	paclitaxel poliglumex
Xeloda	Capecitabine
Xeloda (Capecitabine)	Capecitabine
Xeloda(capecitabine)	Capecitabine
Xelox	Capecitabine+Oxaliplatin
Xgeva	Denosumab
Xyotax	Paclitaxel
Yervoy	Ipilimumab
Yondelis	Trabectedin
ZD6474	Vandetanib
ZG 10	NO-FIND
ZG-10	NO-FIND
ZOLADEX	goserelin
ZOLEDRONIC ACID	zoledronate
ZOLENDRONIC ACID	zoledronate
Zofran	Ondansetron
Zoladex	Goserelin
Zometa	Zoledronic acid
abraxane	Paclitaxel
ac	Doxorubicin+Cyclophosphamide
acccutane	accutane
actinomycin d	Dactinomycin
adriamicin	Doxorubicin
adriamicin	adriamycin
adriamycin	Doxorubicin
adriamycin+cuclophosphamide	Doxorubicin+Cyclophosphamide
adriamycin+cyclophosphamid	Doxorubicin+Cyclophosphamide
adriamycin+cyclophosphamide	Doxorubicin+Cyclophosphamide
adrimicin+cyclophosphamide	Doxorubicin+Cyclophosphamide
adrimycin+cyclophosphamide	Doxorubicin+Cyclophosphamide
alimta	Pemetrexed
anastrazolum	anastrozole
anastrozolum	Anastrozole
anastrozolum	anastrozole
arimidex	Anastrozole
aromasin	Exemestane
aromatase exemestane	Exemestane
autologous vaccine	ATCV
avastin	Bevacizumab
camptosar	Irinotecan
carbopaltin	Carboplatin
carboplatinum	Carboplatin
casodex	Bicalutamide
ciclofosfamida	Cyclophosphamide
cis-retinoic acid	Isotretinoin
cisplatim	Cisplatin
cisplatinum	Cisplatin
clodronic acid	Clodronate
cyclophosphamid	Cyclophosphamide
cyclophosphamide+methotrexatum+fluorouracillum	Cyclophosphamide+Methotrexatum+Fluorouracil
cyclophosphamide, vincristine, and dacarbazine	Cyclophosphamide+Vincristine+Dacarbazine
cyclophosphamidum	Cyclophosphamide
cytomel	Liothyronine
cytoxan	Cyclophosphamide
dcVax	NO-FIND
decadron	Dexamethasone
discido	NO-FIND
doxil	Doxorubicin
doxorubicin HCL	Doxorubicin
doxorubicin+ cyclophosphamide	Doxorubicin+Cyclophosphamide
doxorubicin+cyclophosphamid	Doxorubicin+Cyclophosphamide
doxorubicina	Doxorubicin
doxorubicine	Doxorubicin
doxorubicine cyclophosphamide tamoxifen	Doxorubicin+Cyclophosphamide+Tamoxifen
doxorubicine+cyclophosphamide	Doxorubicin+Cyclophosphamide
doxorubicine+cyclophosphamide+tamoxifen	Doxorubicin+Cyclophosphamide+Tamoxifen
epirubicinum	Epirubicin
erbitux	Cetuximab
etoposide (VP-16)	Etoposide
faslodex	Fulvestrant
femara	Letrozole
fluorouracilum	Fluorouracil
folinian	Leucovorin
folinic acid	Leucovorin
gemcitabine HCL	Gemcitabine
gemzar	Gemcitabine
herceptin	Trastuzumab
interferon	NOS
interferon alpha	Interferon A
interferon-alpha	Interferon A
interleukin-2	Aldesleukin
intrathecal methotrexate	Methotrexate
intron a	Interferon A
jevtana	Cabazitaxel
letrozole femara	Letrozole
letrozolum	Letrozole
leucovorin calcium	Leucovorin
levoxyl	Levothyroxine
lupron	Leuprolide
methotrexate+5 fluorouracil+cyclophosphamide	Methotrexate+Fluorouracil+Cyclophosphamide
metilprednisona	Methylprednisolone
metotreksat	Methotrexate
nab-rapamycin	Rapamycin
navelbine	Vinorelbine
neulasta	Pegfilgrastim
nolvadex	Tamoxifen
oncophage vaccine	Vitespen
otherwise	NO-FIND
oxaliplatinum + 5-FU	Oxaliplatin+Fluorouracil
oxaliplatinum+ 5-FU	Oxaliplatin+Fluorouracil
oxaliplatinum+5 fluorouracilum	Oxaliplatin+Fluorouracil
oxaliplatinum+5-FU	Oxaliplatin+Fluorouracil
paclitaxelum	Paclitaxel
pemetrexed disodium	Pemetrexed
prednisona	Prednisone
premetrexed	Pemetrexed
proleukin (IL-2)	Aldesleukin
rec MAGE	MAGE-3-AS-AS15-ASCI
rec MAGE 3-AS + AS15 ACS1 / Placebo Vaccine	MAGE-3-AS-AS15-ASCI
rec MAGE3-AS+AS15 ASCI vs Placebo	MAGE-3-AS-AS15-ASCI
recMAGE- A3	MAGE-A3
recMAGE3-AS+AS15 ASCI/Placebo vaccine	MAGE-3-AS-AS15-ASCI
recPRAME+AS15	GSK2302025A
recPRAME+AS15 ASCI	GSK2302025A
retinoic	retinoic acid
specified	NO-FIND
sunitinib (sutent)	Sunitinib
sutent	Sunitinib
sutent (sunitinib)	Sunitinib
synthroid	Levothyroxine
tamoxifen citrate	Tamoxifen
tamoxiphen	tamoxifen
tamoxiphen+anastrazolum	Tamoxifen+Anastrozole
tamoxiphene	Tamoxifen
tamoxiphene	tamoxifen
tamoxiphene+anastrozolum	Tamoxifen+Anastrozole
tamoxiphene+leuporeline+gosereline	Tamoxifen+Leuprolide+Goserelin
taxol	Paclitaxel
taxol+adriamycin+cyclophosphamide+herceptin	Paclitaxel+Doxorubicin+Cyclophosphamide+Trastuzumab
taxotere	Docetaxel
tc	Docetaxel+Cyclophosphamide
temodar	Temozolomide
vectibix	Panitumumab
vincristina	Vincristine
xeloda	Capecitabine
acctuane	Accutane
adriamyicin	Adriamycin
adrimicin	Adimicin
adrimycin	Adriamycin
albumin	Albuminamide
alferon	Alleron
almita	Palmita
alvesin	Aloesin
amitostin	amifostine
amitostine	amifostine
armidex	Arimidex
armour	Armor
aromatase	aromatase inhibitor i
attac	Attack
axitnib	Axitinib
bacillus	Bacillus thuringiensis B toxin
bicalutamid	bicalutamide
braf	BRAF inhibitor
Bromodomain Inhibitor	Bromodomain Inhibitor, (+)-JQ1
capecetabine	CAPECITABINE
capecytabinum	capecitabinum
carbobplatin	carboplatin
carbplatin	carboplatin
cedicanib	Cediranib
celbrex	Celebrex
cepecitabine	CAPECITABINE
cilenaitide	Cilengitide
cilengtide	Cilengitide
ciplastin	cisplatinum
cisplatain	cisplatinum
cisplatnin	cisplatinum
cyclophasphamide	cyclophosphamide
cyclophospamide	cyclophosphamide
cyotxan	Cytoxan
cytoxen	Cytoxan
cytoxin	Cytoxan
dacabarzine	dacarbazine
decodron	Decadron
dendriticcell	Dendritis
dendritic	Dendritis
dexaethasone	dexamethasone
dexamethasome	dexamethasone
dexamethsone	dexamethasone
dexamthasone	dexamethasone
dexmethasone	dexamethasone
docetaxelum	docetaxel
docetoxel	docetaxel
doxetaxel	docetaxel
doxetaxol	docetaxel
doxifluridin	doxifluridine
doxirubicin	doxorubicin
doxobubicin	doxorubicin
doxorubincin	doxorubicin
eloxatin	Eloxatin (TN)
epirubicoin	Epirubicin
erlotonib	Erlotinib
etoposid	etoposide
flourouracil	5-Fluorouracil
folinic	folinic acid
fuluestrant	Fulvestrant
gamzar	Gemzar
gemar	Gemzar
gemcitibane	gemcitabine
gemicitabine	gemcitabine
gemictiabine	gemcitabine
gemox	Gerox
gemzan	Gemzar
gemzet	Gemzar
gezmar	Gemzar
gliadle	Gliadel
gomzar	Gemzar
hexamethymelamine	HEXAMETHYLMELAMINE
hydoxyurea	hydroxyurea
hydrochoroquine	HYDROXYCHLOROQUINE SULFATE
hydroxurea	hydroxyurea
hydroxyuerea	hydroxyurea
hydroyurea	hydroxyurea
hyrdroxyurea	hydroxyurea
hyroxyurea	hydroxyurea
ifostamide	ifosfamide
irintocean	irinotecan
irintotecan	irinotecan
ironotecan	irinotecan
IRX5183	215183-27-0
isotrectinoin	Isotretinoin
karerltecin	Karenitecin
leuocvorin	leucovorin
levcovorin	leucovorin
levenracetam	Levetiracetam
Linsitnib	Linsitinib
lumustine	lomustine
luprolide	leuprolide
melphalon	melphalan
mustophoran	Mustophorane
nab	nabumetone
naxavar	Nexavar
nexavaar	Nexavar
oxaloplatin	Oxaliplatinum
pacilatxel	paclitaxel
paciltaxal	paclitaxel
paciltaxel	paclitaxel
paciltaxle	paclitaxel
pacitaxel	paclitaxel
pacitaxol	Paclitaxol
pacliatxel	paclitaxel
pacliltaxel	paclitaxel
paclitaxil	paclitaxel
palixtaxel	paclitaxel
predisone	prednisone
procarbizine	procarbazine
sarafenib	Sorafenib
sargramostin	Sarcostin
sovatenib	Sorafenib
tamoxiten	tamoxifen
tanceva	Tarceva
tarveca	Tarceva
TASIN-1	CASIN
taxel	Paclitaxel (Taxol)
taxoterecin	Taxotere
temazolomide	temozolomide
temodor	Temodar
temoxolomide	temozolomide
temozlomide	temozolomide
temozolomode	temozolomide
temozolomoide	temozolomide
temozomide	temozolomide
themozolomide	temozolomide
tipfarnib	Tipifarnib
tomaxifen	tamoxifen
topecan	Torecan
topetecan	topotecan
toptecan	topotecan
trenantone	Trenbolone acetate
unkown	UNKNOWN
